MsgWave=Wave %d
MsgWaveCleared=Wave %d done!
MsgOutOfRelaunchs=%s has no more relaunchs.
MsgRelaunch=Relaunch %s.

EnemyPilot=Pilot
EnemyCrewman=Crewman
EnemyDefender=Shield Fighter
EnemyBow=Archer
EnemyArtillery=Artillery
EnemyBalloon=Parachutist
EnemyRocket=Rocketeer

WaveFirst=Just the vanguard
WaveSecond=Rocket squadron
WaveThird=Rocket riders
WaveFourth=Rocket rider squadron
WaveFifth=Airship maneuver
WaveSixth=Air force
WaveSeventh=Parachute drop
WaveEighth=Heavy air force
WaveNinth=Task force
WaveTenth=Full attack

TeamAttackers=Attackers
TeamDefenders=Defenders

HomebaseWeapons=Weapons
HomebaseItems=Items
HomebaseTechnology=Technology
HomebaseUpgrades=Upgrades
HomebaseArtifacts=Artifacts

HomebaseDescBow=Medium range, low damage. Endless arrows.
HomebaseDescJavelin=Short range, high damage. Endless javelins.
HomebaseDescBlunderbuss=High range, medium damage. Endloss bullets.
HomebaseDescGrenadeLauncher=Launches bombs at the enemies. Infinite bombs.
HomebaseDescWindBag=Releases air blasts to knock enemies of their feet.
HomebaseDescHammer=To construct defensive towers and other buildings.

HomebaseLoadSpeed=Load speed
HomebaseDescLoadSpeed=Shortens reload time of ranged weapons (all).
HomebaseShootingStrength=Shooting strength.
HomebaseDescShootingStrength=Strengthens weapons, makes them shoot further (except blunderbuss).
HomebaseLife=Life energy
HomebaseDescLife=Makes your clonk able to take more damage.
HomebaseAdvancedWeapons=Advanced weapons
HomebaseDescAdvancedWeapons=Unlocks more weapons and upgrades.
HomebaseMasterWeapons=Master weapons
HomebaseDescMasterWeapons=Unlocks more weapons and upgrades.
