UserAction=Action
UserColor=Couleur
UserObject=Objet
UserObjectList=List d'objet
UserPlayer=Joueur
UserPlayerList=Joueurs
UserInteger=Entier
UserColor=Couleur
UserString=Texte
UserBoolean=Booléen
UserDefinition=Type d'objet
UserPosition=Position
UserOffset=Décalage
UserAny=Valeur
Default=Par défaut
Structure=Structure
Game=Jeu
Disasters=Catastrophes
None=Rien
Noone=Aucun
AllPlayers=Tous les joueurs
Sequence=Séquence
Wait=Attendre le temps
Time=Temps (Frames)
ActionObject=Object d'action (this)
TriggerObject=Objet déclencheur
TriggerClonk=Clonk déclencheur
TriggeringPlayer=Joueur déclencheur
UserActionProgressMode=Enregistrer la progression
Session=Ne pas sauvegarder
PerPlayer=Par joueur
Player=Joueur
Global=Globalement
ParallelAction=Exécution parallèle
Goto=Aller à l'index de la séquence
StopSequence=Quitter la séquence
SuspendSequence=Suspendre la séquence
Index=Index
Actions=Actions
Constant=Constant
ConstantObject=Choisir l'objet
Value=Valeur
SequenceHelp=Permet l'exécution de plusieurs actions dans une série. La liste sera évaluée de haut en bas. En utilisant des commandes ou des messages «aller à» avec plusieurs options, il est également possible de passer d'un index à l'autre dans les séquences.
GotoHelp=Définit le point d'exécution actuel sur l'index donné dans la séquence parent.
StopSequenceHelp=Met fin à la séquence actuelle et réinitialise sa progression. Lors de la prochaine exécution, la séquence recommencera depuis le début.
SuspendSequenceHelp=Termine la séquence actuelle et enregistre sa progression. Si l'action est à nouveau déclenchée, la séquence reprend après cette action.
WaitHelp=Met en pause la séquence en cours à un moment donné et continue avec l'action suivante après la pause.
ActionObjectHelp=Objet dans lequel cette action est définie. Pour les actions définies dans les commutateurs, ce serait l'objet commutateur. Pour les dialogues, ce serait l'objet de dialogue.
TriggerClonkHelp=Le clonk du joueur sélectionné qui a déclenché l'exécution de cette action.
TriggerObjectHelp=L'objet qui a déclenché cette action. Dans les dialogues, ce serait le clonk sélectionné du joueur. Pour les déclencheurs comme «Terminer la construction», ce serait le bâtiment nouvellement construit.
ConstantObjectHelp=Sélectionner un objet dans une liste.
TriggeringPlayerHelp=Le joueur qui a déclenché cette action.
AllPlayersHelp=Tous les joueurs humains.
ConstantHelp=Spécifier une valeur directement.
UserActionProgressModeHelp=Spécifie si la progression de cette séquence est stockée globalement, par joueur ou uniquement par exécution. Par exemple, si la progression d'un dialogue est stockée globalement et qu'un deuxième joueur parle au même clonk pendant qu'un autre joueur lit un message, le deuxième joueur continuerait le dialogue là où le premier joueur s'est arrêté. Si la progression est enregistrée par joueur, chaque joueur obtient un dialogue indépendant.
ParallelActionHelp=Spécifie si l'action peut être lancée plusieurs fois en parallèle. Ceci est pertinent si la durée de l'action est longue (par exemple parce qu'un message de dialogue ou un temps d'attente dans la séquence) et le même événement est déclenché par un autre joueur pendant le temps d'attente.
Ambience=Ambiance
Sound=Son
SoundHelp=Lit un fichier son.
SoundName=Nom du son
SoundNameHelp=Nom du fichier son à lire.
SoundPitch=Pitch
SoundPitchHelp=Modulation de la hauteur. Les valeurs valides sont comprises entre -90 et +1000. À 0, le son sera joué normalement. Des valeurs plus petites signifient un son plus grave et plus lent. Des valeurs plus élevées signifient un son plus aigu et plus rapide.
SoundVolume=Volume
SoundVolumeHelp=Volume sonore relatif. Valeurs 0-100. La valeur par défaut est 100.
SoundLoop=Boucle
SoundLoopHelp=Sur «Boucle active», le son sera reproduit jusqu'à ce qu'un son portant le même nom et l'objet source soit lu avec le paramètre «Boucle inactive». Si «Aucun», le son est joué exactement une fois.
SoundLoopNone=Aucun
SoundLoopOn=Boucle active
SoundLoopOff=Boucle inactive
SoundTargetPlayersHelp=Joueurs pour qui le son est joué.
SoundSourceObject=Object d'origine
SoundSourceObjectHelp=Objet utilisé comme source du son. Les sons d'objets ne sont joués que si l'objet est à proximité et sont orientés en fonction de la position de l'objet par rapport à l'écran.
Here=Ici
Object=Objet
CreateObject=Créer un objet
CreateObjectHelp=Crée un nouvel objet à la position spécifiée ou contenu dans un autre objet.
CreateObjectDefinitionHelp=La définition, c'est-à-dire le type d'objet, de l'objet nouvellement créé.
CreateObjectPositionHelp=Où créer le nouvel objet. Uniquement pertinent si aucun conteneur n'est spécifié.
CreateObjectCreationOffset=Décalage
CreateObjectCreationOffsetHelp=Où se trouve le point de création du nouvel objet créé.
Center=Centre de l'objet
Bottom=Bordure inférieure de l'objet
Owner=Propriétaire
CreateObjectOwnerHelp=Propriétaire du nouvel objet. Détermine la couleur de l'objet et par ex. l'affiliation aux mâts.
Container=Conteneur
CreateObjectContainerHelp=S'il est spécifié, l'objet sera créé dans le contenu de cet autre objet. Par exemple. pour créer des objets directement dans l'inventaire d'un clonk ou d'un coffre.
SpeedX=Vitesse X
CreateObjectSpeedXHelp=Vitesse horizontale du nouvel objet en 1/10e pixels par image.
SpeedY=Vitesse Y
CreateObjectSpeedYHelp=Vitesse verticale du nouvel objet en 1/10e pixels par image.
Rotation=Rotation
CreateObjectRotationHelp=Rotation de l'objet en degrés.
SpeedR=Vitesse de rotation
CreateObjectSpeedRHelp=Vitesse de rotation en degrés par image.
LastCreatedObject=Dernier objet créé
LastCreatedObjectHelp=L'objet qui a été créé en dernier à l'aide d'une action «Créer un objet» dans ce contexte.
RemoveObject=Supprimer un objet
RemoveObjectHelp=Supprime un objet du jeu.
RemoveObjectObject=L'objet à supprimer.
EjectContents=Contenu
EjectContentsHelp=Que faire si l'objet supprimé contient d'autres objets.
EjectContentsNo=Supprimer le contenu
EjectContentsYes=Éjecter le contenu
Position=Position
ConstantPositionAbsolute=Constante (absolue)
ConstantPositionAbsoluteHelp=Définit une position en coordonnées absolues du paysage. La position peut être ajustée à l'aide d'un marqueur rouge dans la fenêtre de visualisation.
ConstantPositionRelative=Constante (relative)
ConstantPositionRelativeHelp=Définit une position par rapport à l'objet édité. La position peut être ajustée à l'aide d'un marqueur rouge dans la fenêtre de visualisation.
Coordinates=Coordonnées
CoordinatesHelp=Position définie via les coordonnées X (horizontal) et Y (vertical).
PosXHelp=Coordonnées horizontales par rapport à la bordure gauche du paysage.
PosYHelp=Coordonnées verticales par rapport à la bordure supérieure du paysage.
PositionOffset=Position+Décalage
PositionOffsetHelp=Calcule une position comme position de base plus un décalage.
PositionOffsetPositionHelp=Position de base à laquelle le décalage est appliqué.
PositionOffsetOffsetHelp=Décalage à appliquer.
ConstantOffsetRelative=Décalage constant
ConstantOffsetRelativeHelp=Définit un décalage constant. Le décalage peut être modifié à l'aide d'un marqueur rose dans la fenêtre de visualisation.
OffXHelp=Décalage horizontal.
OffYHelp=Décalage vertical.
AddOffsets=Ajouter des décalages
AddOffsetsHelp=Ajoute deux décalages partiels à un grand décalage.
AddOffsetOffsetHelp=Décalage partiel.
Random=Nombre aléatoire
RandomIntHelp=Valeur aléatoire entre un minimum (inclus) et un maximum (inclus).
Min=Minimum
RandomMinHelp=Le plus petit nombre possible
Max=Maximum
RandomMaxHelp=Le plus grand nombre possible
ObjectPosition=Position de l'objet
ObjectPositionHelp=Position actuelle d'un objet.
ObjectPositionObjectHelp=Objet dont la position est utilisée.
DiffPositions=Différence entre les positions
DiffPositionsHelp=Calcule le décalage de la position A à la position B (décalage = B - A)
PositionA=Position A
PositionAHelp=Position de départ
PositionB=Position B
PositionBHelp=Position de fin
RandomPosition=Position aléatoire...
RandomRectAbs=...dans un rectangle (absolue)
RandomRectAbsHelp=Sélectionne un point aléatoire dans un carré (région jaune). La région est placée par rapport au paysage.
Rectangle=Rectangle
RandomRectRel=...dans un  rectangle (relative)
RandomRectRelHelp=Sélectionne un point aléatoire dans un carré (région turquoise). La région est placée par rapport à l'objet sélectionné.
RandomCircleAbs=...dans un cercle (absolue)
RandomCircleAbsHelp=Sélectionne un point aléatoire dans un cercle (région violette). La région est placée par rapport au paysage.
Circle=Cercle
RandomCircleRel=...dans un cercle (relative)
RandomCircleRelHelp=Sélectionne un point aléatoire dans un cercle (région violette). La région est placée par rapport à l'objet sélectionné.
RandomOffRectRel=Aléatoire dans un rectangle
RandomRectRelHelp=Choisit un décalage aléatoire dans un carré (région turquoise).
RandomOffCircleRel=Aléatoire dans un cercle
RandomCircleRelHelp=Choisit un décalage aléatoire dans un carré (région violette).
Global=Globale
CastObjects=Lancer des objets
CastObjectsHelp=Crée et lance plusieurs objets à partir d'une position.
CastObjectsDefinitionHelp=Définition des objets à créer.
CastObjectsPositionHelp=Position à partir de laquelle les objets sont lancés.
Amount=Nombre
CastObjectsAmountHelp=Nombre d'objets à lancer.
Speed=Vitesse
CastObjectsSpeedHelp=Vitesse moyenne à laquelle les objets sont projetés. En 1/10e pixels par frame.
MeanAngle=Angle moyen
CastObjectsMeanAngleHelp=Angle moyen en degrés auquel les objets sont projetés. 0 est vers le haut, les angles positifs tournent dans le sens horaire.
AngleDeviation=Déviation angulaire
CastObjectsAngleDeviationHelp=Plage d'angle dans laquelle les objets sont projetés. Réglez sur 360 pour lancer dans toutes les directions.
CastObjectsOwnerHelp=Propriétaire d'objets nouvellement créés.
Comparison=Comparaison
CompareInteger=Comparer des nombres
ComparisonHelp=Compare deux valeurs avec un opérateur.
LeftOperand=Opérande de gauche
LeftOperandHelp=Valeur à gauche de l'opérateur de comparaison.
Operator=Opérateur
OperatorHelp=Opérateur de comparaison
EqualHelp=Vrai si les deux opérandes sont égaux.
NotEqualHelp=Vrai si les opérandes ne sont pas égaux.
LessThanHelp=Vrai si l'opérande gauche est plus petit que l'opérande droit.
GreaterThanHelp=Vrai si l'opérande gauche est plus grand que l'opérande droit.
LessOrEqualHelp=Vrai si l'opérande gauche est inférieur ou égal à l'opérande droit.
GreaterOrEqualHelp=Vrai si l'opérande gauche est inférieur ou égal à l'opérande droit.
RightOperand=Opérande de droite
RightOperandHelp=Valeur de droite de l'opérateur de comparaison.
CompareBoolean=Comparer des booléens
CompareObject=Comparer des objects
CompareString=Comparer des textes
CompareDefinition=Comparer des types d'object
ComparePlayer=Comparer des joueurs
ObjectExists=L'objet existe
ObjectExistsHelp=Vrai si la fonction renvoie un objet.
TypeOfObject=Type d'objet
TypeOfObjectHelp=Détermine le type de l'objet donné
Script=Script
SetVariable=Définir la variable
SetVariableHelp=Stocke une valeur afin de la récupérer plus tard.
Context=Contexte
VariableContextHelp=Contexte de stockage de cette variable. Les variables dans le contexte global sont les mêmes pour tous les appels. Les variables dans le contexte local ne se chevauchent que si le même objet est fourni.
VariableName=Nom
VariableNameHelp=Nom de la variable. La casse, c'est-à-dire foo et Foo sont des variables distinctes. Seuls les caractères a-z, A-Z, 0-9 et _ peuvent être utilisés. La variable peut ne pas commencer par un nombre. Les caractères illégaux seront filtrés et _ ajouté au besoin.
SetVariableValueHelp=Valeur à affecter à cette variable. Si un objet est attribué puis supprimé, toutes les variables pointant vers cet objet seront vidées.
Variable=Variable
VariableHelp=Variable définie par l'utilisateur, dans laquelle une valeur a été précédemment stockée à l'aide de l'action «Définir la variable». Les valeurs doivent être interrogées en utilisant le même type de données (par exemple, Entier ou Texte) qu'elles ont été stockées.
Distance=Distance
DistanceHelp=Calcule la distance entre deux positions A et B.
ValueToString=Valeur vers chaîne de caractères
ValueToStringHelp=Convertit une valeur d'un autre type en chaîne de caractères
Log=Journal
LogHelp=Générer un message de journal de débogage.
LogMessage=Message
LogMessageHelp=Le texte à générer.
Concat=Concaténer
ConcatHelp=Concatène plusieurs petits textes en un seul long texte.
Substrings=Textes
ScriptHelp=Exécute un script personnalisé. Attention: les scripts ne seront pas vérifiés et peuvent tout gâcher!
ScriptCommand=Script
ScriptCommandHelp=Ligne de script à exécuter. Une seule commande.
ScriptContextHelp=Contexte d'exécution du script.
EmptyString=Aucun texte
Logic=Logique
Not=Non
NotHelp=Inverse l'opérande.
And=Et
AndHelp=Vrai si tous les opérandes sont vrais.
Operands=Opérandes
Or=Ou
OrHelp=Vrai si au moins un opérande est vrai.
FindObjectsInArea=Objets dans la zone
FindObjectsInAreaHelp=Recherche des objets dans une zone donnée du paysage.
ID=Type d'objet
FindObjectsIDHelp=Type d'objet à rechercher. Avec 'Tous', tous les types d'objets sont trouvés.
Any=Tous
SearchArea=Plage de recherche
SearchAreaHelp=Détermine la zone de la carte à rechercher.
SearchAreaWholeMap=Carte entière
SearchAreaWholeMapHelp=Les objets se trouvent n'importe où.
SearchAreaInRect=Dans un rectangle
SearchAreaInRectHelp=Recherche les objets dont le milieu se trouve dans le rectangle donné.
SearchAreaAtRect=Au rectangle
SearchAreaAtRectHelp=Recherche les objets dont la forme chevauche le rectangle donné.
SearchAreaCircle=Dans un cercle
SearchAreaCircleHelp=Recherche les objets qui ont leur point médian dans le cercle donné.
SearchAreaNearPosition=Autour du point
SearchAreaNearPositionHelp=Recherche les objets dont le milieu se situe dans un rayon autour d'un point. Le point peut être donné en fonction.
Radius=Rayon
AllowContained=Trouver ce qui est contenu
AllowContainedHelp=Spécifie si des objets contenus sont également trouvés (par exemple, des objets d'inventaire ou des clonks dans un plan).
FindObjectsInContainer=Contenu de l'objet
FindObjectsInContainerHelp=Recherche tout le contenu d'un type donné dans un conteneur.
FindObjectInArea=Objet dans la zone
FindObjectInAreaHelp=Recherche et objet dans une zone donnée du paysage.
FindObjectInContainer=Objet contenu
FindObjectInContainerHelp=Recherche un objet contenu d'un type donné dans un conteneur.
NumberOfObjects=Nombre d'objets
NumberOfObjectsHelp=Nombre d'éléments dans une liste d'objets. La liste d'objets est donnée en fonction.
NumberOfPlayers=Nombre de joueurs
NumberOfPlayersHelp=Nombre de joueurs dans une liste de joueurs. La liste des joueurs est donnée en fonction.
LeftArithmeticOperandHelp=Valeur à gauche de l'opérateur mathématique.
RightArithmeticOperandHelp=Valeur à droite de l'opérateur mathématique.
Arithmetic=Arithmetique
Sum=Somme
SumHelp=Ajoute deux nombres.
Sub=Différence
SumHelp=Soustrait l'opérande de droite à l'opérande de gauche.
Mul=Produit
MulHelp=Multiplie deux nombres.
Div=Division
DivHelp=Divise l'opérande gauche par l'opérande droit. Le résultat est arrondi vers zéro.
Mod=Modulo
ModHelp=Renvoie le reste de la division de l'opérande gauche par l'opérande droit.
PlayerWealth=Richesse du joueur
PlayerWealthHelp=Richesse d'un joueur (Argent, or, clunkers ...).
ClonkEnergy=Énergie du clonk
ClonkEnergyHelp=Point de vide du clonk.
Clonk=Clonk
ObjectMass=Masse de l'objet
ObjectMassHelp=Poids de l'objet spécifié.
ObjectSpeed=Vitesse de l'objet
ObjectSpeedHelp=Vitesse de l'objet spécifié en 1/10e pixels par frame.
OwnerOfObject=Propriétaire de l'objet
OwnerOfObjectHelp=Joueur possédant un objet spécifié.
ControllerOfObject=Joueur qui contrôle
ControllerOfObjectHelp=Joueur contrôlant un objet spécifié. Par exemple le joueur poussant actuellement un véhicule ou un interrupteur ou le joueur qui a lancé une pierre de feu.
PositionX=Position X
PositionXHelp=Composante horizontale d'une position.
PositionY=Position Y
PositionYHelp=Composante verticale d'une position.
ConditionalAction=Action conditionnelle
ConditionalActionHelp=Exécute une action uniquement si une condition est vraie.
Condition=Condition
IfConditionHelp=Condition qui décide si l'action conditionnelle de l'action alternative est exécutée.
TrueEvaluator=Action conditionnée
TrueEvaluatorHelp=Action exécutée si la condition est vraie.
FalseEvaluator=Action alternative
FalseEvaluatorHelp=Action exécutée si la condition est fausse.
DoEnergy=Ajuster l'énergie
DoEnergyHelp=Augmente ou diminue l'énergie d'un objet vivant (par exemple un clonk). Si l'énergie tombe à ou en dessous de 0, l'objet meurt. L'énergie ne peut pas être augmentée au-delà de l'énergie maximale de l'objet (50 pour les clonks).
DoEnergyObjectHelp=Objet pour lequel l'énergie est ajustée.
ValueChange=Changer
DoEnergyValueChangeHelp=Valeur ajoutée à l'énergie actuelle de l'objet.
SetPosition=Déplacer un objet
SetPositionHelp=Place un objet dans une nouvelle position.
SetPositionObjectHelp=Objet à déplacer.
SetPositionPositionHelp=Nouvelle position pour l'objet.
GameOver=Partie terminée
GameOverHelp=Termine le tour et montre le dialogue d'évaluation. Tous les joueurs qui n'ont pas été éliminés seront déclarés gagnants.
Fling=Fling object
FlingHelp=Modifie la vitesse d'un objet et laisse les animaux et les clonks sauter ou dégringoler.
FlingObjectHelp=Flung object.
FlingSpeedXHelp=Vitesse horizontale en 1/10px par frame.
FlingSpeedYHelp=Vitesse verticale en 1/10px par frame.
AddSpeedY=Ajouter de la vitesse
FlingAddSpeedHelp=Indique si la vitesse existante doit être ajoutée à la vitesse de lancement.
DoWealth=Changer la richesse
DoWealthHelp=Ajoute ou supprime un clunker du compte du joueur.
Change=Changer
DoWealthChangeHelp=Nombre de clunkers à ajouter (positif) ou à retirer (négatif) du compte du joueur.
DoWealthSoundHelp=Si un son d'espèces doit être joué indiquant le changement de richesse.
CastParticles=Lancer des particules
CastParticlesHelp=Propage des particules graphiques à partir d'un point dans toutes les directions.
ParticleName=Nom
ParticleNameHelp=Forme des particules lancées.
CastParticlesAmountHelp=Nombre de particules lancées.
CastParticlesSpeedHelp=Vitesse des particules lancées en 1/10px par frame.
Lifetime=Durée de vie
CastParticlesLifetimeHelp=Nombre de frames durant lequel les particules existent.
Size=Taille
CastParticlesSizeHelp=Taille des particules lancées.
SizeEnd=Taille finale
CastParticlesSizeEndHelp=Taille à la fin de la durée de vie de la particule. Peut être réglé sur 0 pour laisser la particule rétrécir dans le néant.
Color=Couleur
CastParticlesColorHelp=Couleur des particules lancées.
BlitMode=Mode de dessin
ParticleBlitModeHelp=Comment les particules sont dessinées sur le fond. Additif: les particules n'éclairent que le paysage.
Normal=Normal
Additive=Additif
Mod2=Mod2
Gravity=Gravité
ParticleGravityHelp=Attraction gravitationnelle sur les particules en pourcentage de l'attraction régulière. 0: La particule flotte librement. 100: La particule tombe comme tout autre objet.
FadeOut=Fondu
ParticleFadeOutHelp=Si les particules deviennent transparentes avec le temps.
CollisionFunc=Comportement de collision
ParticleCollisionFuncHelp=Ce qui arrive aux particules en frappant le paysage.
Pass=Passer à travers
Stop=Stopper
Bounce=Rebondir
Die=Disparaît
Dust=Poussière
Flash=Éclat
Magic=Magie
Smoke=Fumée
Sphere=Sphère
StarFlash=Étoile
StarSpark=Soleil
Fire=Feu
Ring=Anneau
LastUsePosition=Position d'activation
LastUsePositionHelp=Valable pour les éléments activés tels que la baguette magique: position de la souris où le joueur a activé l'élément.
PlrKnowledge=Donner des connaissances
PlrKnowledgeHelp=Permet à un ou plusieurs joueurs de construire une nouvelle structure ou un nouvel objet.
ConditionalValue=Valeur conditionnelle
ConditionalValueHelp=Utilise l'une des deux valeurs selon qu'une condition est vraie.
IfConditionValueHelp=Condition déterminant laquelle des deux valeurs utiliser.
TrueEvaluatorValue=Valeur 'vrai'
TrueEvaluatorValueHelp=Valeur utilisée si la condition est vraie.
FalseEvaluatorValue=Valeur 'faux'
FalseEvaluatorValueHelp=Valeur utilisée si la condition est fausse.
Comment=Commentaire
CommentHelp=Commande qui ne fait rien. Utilisez-le pour annoter vos séquences.
ForInteger=Boucle: Pour chaque numéro ...
ForIntegerHelp=Exécute une action une fois pour chaque numéro d'une plage. Le numéro actuellement bouclé est accessible en tant que 'numéro de boucle'.
ForActionHelp=Action répétée dans la boucle.
ForPlayer=Boucle: Pour chaque joueur ...
ForPlayerHelp=Exécute une action une fois pour chaque joueur d'une liste. Le lecteur actuellement en boucle est accessible en tant que 'joueur de boucle'.
ForPlayersHelp=Liste des joueurs pour lesquels l'action est exécutée.
ForObject=Boucle: Pour chaque objet ...
ForObjectHelp=Exécute une action une fois pour chaque objet d'une liste. L'objet actuellement en boucle est accessible en tant que 'objet de boucle'.
ForObjectsHelp=Liste des objets pour lesquels l'action est exécutée.
IteratedObject=Objet de boucle
IteratedObjectHelp=Objet de la dernière action 'Boucle: Pour chaque objet ...'.
IteratedPlayer=Joueur de boucle
IteratedPlayerHelp=Joueur de la dernière action 'Boucle: Pour chaque joueur ...'.
IteratedInteger=Numéro de boucle
IteratedIntegerHelp=Numéro de la dernière action 'Boucle: Pour chaque numéro ...'.
ForStartHelp=Numéro de début d'itération. Inclus.
ForEndHelp=Numéro de fin d'itération. Inclus.
ForStepHelp=Taille de l'étape d'itération.
Start=Début
End=Fin
Step=Taille de l'étape
RandomColor=Couleur aléatoire
RandomColorHelp=Couleur aléatoire entre deux couleurs extrêmes A et B dans l'espace colorimétrique RVB.
ColorA=Couleur A
ColorB=Couleur B
RGB=RVB
RGBHelp=Composé d'une couleur composée de composants rouges, verts et bleus.
Red=Rouge
Green=Vert
Blue=Bleu
PlayerColor=Couleur du joueur
PlayerColorHelp=Couleur primaire d'un joueur.
EnterObject=Introduire un objet
EnterObjectHelp=Place un objet dans un conteneur. Par exemple, un élément dans un clonk.
EnterObjectObjectHelp=Élément étant déplacé.
EnterObjectContainerHelp=Conteneur dans lequel l'objet est placé.
CollectionCheck=Si le conteneur est plein ...
CollectionCheckHelp=Que faire si le conteneur ne peut pas prendre l'objet.
CollectionCheckIgnore=Insérer quand même
CollectionCheckCheck=Ne rien faire
CollectionCheckExit=Sortir
ExitObject=Sortir l'objet
ExitObjectHelp=Supprime un objet de son conteneur et le place devant.
SetDirection=Définir la direction de la vue
SetDirectionHelp=Permet à un clonk de regarder à gauche ou à droite.
Direction=Direction
Left=Gauche
Right=Droite
SetVisibility=Définir la visibilité
SetVisibilityHelp=Rend un objet visible ou invisible. Les objets invisibles peuvent être cliqués 'à l'aveugle' dans l'éditeur ou simplement sélectionnés dans la liste des objets.
Visibility=Visibilité
Visible=Visible
Invisible=Invisible
SetVincibility=Définir la vulnérabilité
SetVincibilityHelp=Rend un objet vulnérable ou invincible. Par exemple, un boss final peut être rendu invincible jusqu'à ce qu'un certain sort ait été exécuté.
Vincibility=Vulnérabilité
Invincible=Invincible
Vincible=Vulnérable
ObjectAlive=Objet en vie
ObjectAliveHelp=Si l'objet est un clonk ou un animal et est toujours vivant.
SetPlrView=Définir la vue du joueur
SetPlrViewHelp=Définit la position d'affichage d'un ou plusieurs joueurs sur un objet cible.
Target=Objet cible
PlrViewTargetHelp=Les fenêtres des joueurs sont centrées sur la position de cet objet.
ScrollMode=Mode défilement
SetPlrViewScrollModeHelp=Si la vue se déplace doucement vers la cible ou saute immédiatement
Smooth=Avec douceur
Immediate=Instantanément
WaitForcondition=Attendre la condition
WaitForConditionHelp=Vérifie régulièrement si une condition est remplie et reprend l'action une fois que c'est le cas.
CheckInterval=Intervalle de vérification
WaitConditionHelp=Condition vérifiée.

