Name=Séquence
Description=Permet la création d'intros, de cinématiques ou d'autres événements liés à des déclencheurs tels que des ralliements de joueurs, des joueurs entrant dans des régions ou des productions terminées.
Test=Test
TestHelp=Démarre la séquence.|Le joueur déclencheur est le premier joueur local s'il existe.
Active=Actif
Finished=Terminé
Trigger=Déclencheur
None=Aucun
PlayerEnterRegionRect=Le joueur entre dans le rectangle
PlayerEnterRegionCircle=Le joueur entre dans le rayon
PlayerEnterRegionHelp=Déclenché lorsque le clonk d'un joueur entre dans la région spécifiée.
DeactivateAfterAction=Exécuter une seule fois
GameStart=Début du jeu
PlayerJoin=Ralliement du joueur
PlayerRemove=Joueur supprimé
GoalsFulfilled=Tous les objectifs atteints
ClonkDeath=Un clonk meurt
Construction=Construction de structure
Anything=N'importe quoi
Production=Production d'objet
AnyClonkDeath=Tout clonk meurt
PlayerClonkDeath=Le clonk du joueur meurt
NeutralClonkDeath=Le clonk neutre meurt
SpecificClonkDeath=Un clonk précis meurt...
ObjectEnterRegionRect=L'objet entre dans le rectangle
ObjectEnterRegionHelp=Déclenché lorsqu'un objet d'un type spécifié se trouve dans la région spécifiée.
ID=Type d'objet
IDHelp=Définition du type d'objet qui déclenche cette séquence. S'il est nul, tout objet déclenche la séquence.
ObjectEnterRegionCircle=L'objet de type entre dans le rayon
Condition=Condition
CheckInterval=Intervalle de vérification
CheckIntervalHelp=Définit l'intervalle en frames auquel la condition est vérifiée
ObjectCountInContainer=Nombre d'objet dans le conteneur
CheckOffset=Décallage de vérification
CheckOffsetHelp=Définit un délai en frames pour lequel  l'exécution est retardée dans l'intervalle de vérification. Cette valeur peut être utilisée pour implémenter un décalage entre l'exécution régulière de plusieurs séquences.
ObjectCountInContainer=Nombre d'objet dans le conteneur
ObjectCountInContainerHelp=Déclenché lorsqu'un nombre minimum d'objets est trouvé dans un conteneur. Cela peut par exemple être le cas lorsque le joueur met 20 diamants dans un coffre.
Container=Conteneur
CountContainerHelp=Conteneur dans lequel les objets sont comptés.
CountIDHelp=Type d'objet à compter.
AnyID=Tous
Count=Nombre
Interval=Intervalle
IntervalHelp=La séquence sera exécutée à intervalle régulier. Le paramètre définit l'intervalle en frames.
IntervalTime=Nombre de frames entre les exécutions.
Operation=Opération
CountOperationHelp=Indique si la séquence est déclenchée si plus ou moins du nombre spécifié d'objets se trouvent dans un conteneur. L'opérateur >= peut être utilisé pour déclencher quelque chose lorsqu'un joueur a collecté x cristaux dans un coffre. L'opérateur < peut être utilisé par ex. pour remplir automatiquement un coffre.
GreaterEqual=>=
GreaterEqualHelp=La séquence est déclenchée si le nombre donné ou plusieurs objets sont contenus dans le conteneur.
LessThan=<
LessThanHelp=La séquence est déclenchée si moins que le nombre donné d'objets se trouve dans le conteneur.
SetActive=Activer / désactiver
SetActiveDesc=Active ou désactive le déclenchement d'une séquence.
Status=Statut
SetActiveStatusHelp=Indique si la séquence est activée ou désactivée.
DisablePlayerControls=Désactiver le contrôle du joueur
DisablePlayerControlsHelp=Désactive le contrôle de tous les clonks pour un ou plusieurs joueurs.
Players=Joueurs
PlayerControlsPlayersHelp=Joueurs dont le contrôle est affecté.
MakeInvincible=Invincible
MakeInvincibleHelp=Si tous les clonks sont rendus invincibles lorsque le contrôle est désactivé.
EnablePlayerControls=Activer le contrôle du joueur
EnablePlayerControlsHelp=Réactive le contrôle de toutes les clonks d'un ou plusieurs joueurs.
ActTrigger=Séquence de déclenchement
ActTriggerDesc=Démarre une séquence comme si le déclencheur avait été activé. Vérifie l'état avant.
TriggeringObject=Objet déclencheur
TriggeringObjectHelp=L'objet est revenu en tant qu'objet déclencheur dans la séquence.

