IDListEntry=ID de l'entrée de la liste
None=Aucun
All=Tous les joueurs
Specific=Nombre de joueurs
Team=Nombre d'équipe
Entry=Entrée %s
PlayerMask=Joueurs
CustomInitialization=Script d'initialisation
CustomInitializationHelp=Script à exécuter pour cet objet lors de l'initialisation du scénario. Peut être utilisé pour appliquer des modifications normalement non stockées en tant que propriétés telles que DrawTransform.
VisibilityHelp=Rend un objet visible ou invisible. Les objets invisibles peuvent être cliqués «à l'aveugle» dans l'éditeur ou simplement sélectionnés dans la liste des objets.
Visibility=Visibilité
DefaultVisible=Par défaut (Visible)
Visible=Visible
Invisible=Invisible
Invincibility=Invincible
InVincibilityHelp=L'objet ne peut pas être endommagé ou blessé s'il est activé. Utilisez-le pour les clonks, portes, etc. importants
PlayerColor=Couleur de joueur
PlayerColorHelp=Couleur pour les zones qui sont normalement affichées dans la couleur du joueur.
ClrModulation=Modulation des couleurs
ClrModulationHelp=Facteur par lequel un objet est assombri.
Name=Nom
Unknown=Inconnu
EditorVisible=Uniquement dans l'éditeur
Contents=Contenu
DefaultStack=x%d (Par défaut)
CustomStack=Montant...
InfiniteStack=Infini
ItemPlusParameterList=Objets
Other=Divers
Nothing=Rien
Liquid=Liquide
BlitMode=Mode peinture
BlitModeHelp=Opération de peinture à utiliser pour dessiner des graphiques de cet objet.
Default=Par défaut
Additive=Additif
Mod2=Additif sur la couleur source
Mod2Help=Ajoute la couleur de modulation à la couleur de l'objet moins 128.
Wireframe=Filaire
WireframeHelp=Peint uniquement les bordures de surface du modèle.
