Name=Dialogue
Description=Le dialogue permet au joueur d'interagir avec ce clonk et d'afficher des messages ou d'effectuer une autre action. Définissez une séquence de messages ou d'actions dans la propriété 'Dialogue'.
MsgSpeak=Parler à %s
Next=Suivant
Dialogue=Dialogue
DialogueHelp=Ajoute un dialogue à ce clonk et le sélectionne.| Si un dialogue existe, il sera sélectionné à la place.
Message=Message
Speaker=Orateur
TargetPlayers=Joueurs cibles
ContinueAction=Continuer l'action
WaitForNext=Attendre que 'Suivant' soit appuyé
SuspendAction=Suspendre l'action
StopAction=Arrêter l'action
WaitTime=Attendre un temps fixe
NPC=PNJ
DefaultDialogueMessage=Hello !
DefaultMessage=Message d'exemple
DefaultOptionText=Texte d'option
Options=Options
NoDialogue=Aucun dialogue
Attention=Marqueur
AttentionDesc=Active ou désactive le marqueur rouge d'attention au-dessus de ce this dialogue.
Enabled=Activé
SetAttention=Défini le marqueur de dialogue (!)
Status=Statut
SetEnabled=Activer le dialogue
Target=Objet cible
MessageDesc=Affiche un message de dialogue avec une bordure et un portrait dans la zone centrale supérieure de l'écran.
SetAttentionDesc=Active ou désactive le marqueur d'attention rouge au-dessus d'un dialogue.
SetEnabledDesc=Active ou désactive un dialogue.
NPCDesc=Le clonk cible de ce dialogue. Valable uniquement dans les séquences de dialogues.
TargetDesc=Le PNJ-clonk auquel appartient ce dialogue.
DialogueDesc=Séquence d'actions ou de messages à exécuter pour ce dialogue.
EnabledDesc=Active ou désactive ce dialogue.
Text=Texte
TextHelp=Le contenu du  message.
OptionTextHelp=Texte de sélection de cette option.
Goto=Aller vers
GotoHelp=Index cible dans la séquence parent à laquelle l'exécution se poursuit après la sélection de cette option.

