Speed=Geschwindigkeit
SpeedHelp=Bewegungsgeschwindigkeit in 1/100px pro Frame
Movement=Bewegung
MovementHelp=In welchem Muster sich dieser Stein bewegem soll.
NoMovement=Keine
NoMovementHelp=Der Stein schwebt still in der Luft, wie es Steine so tun.
Horizontal=Horizontal
HorizontalHelp=Horizontal nach links und rechts zwischen zwei Punkten.
Vertical=Vertikal
VerticalHelp=Vertikal nach oben und unten zwischen zwei Punkten.
Graph=Graph
GraphHelp=Bewegung auf einem frei definierbaren Graphen. Punkte hinzufuegen/entfernen mit Umschalt+Steuerung.
Edge=Kante
EdgeHelp=Kanteneigenschaften
EdgeSpeedHelp=Bewegungsgeschwindigkeit in 1/100px pro Frame auf dieser Kante.
Default=Standard
DefaultHelp=Geschwindigkeit wie im Objekt eingestellt.
CustomSpeed=Benutzerdefiniert
CustomSpeedHelp=Diese Kante hat eine eigene Geschwindigkeit.
Vertex=Eckpunkt
VertexHelp=Eigenschaften fuer diesen Knotenpunkt.
ArrivalAction=Aktion
ArrivalActionHelp=Aktion, die bei Ankunft des Steins an diesem Eckpunkt ausgefuehrt wird.
VertexWaitTime=Wartezeit
VertexWaitTimeHelp=Wie lange der Stein an diesem Eckpunkt warten soll, ehe er sich weiter bewegt.
Advancement=Bewegungsrichtung
AdvancementHelp=In welche Richtung sich der Stein nach Ankunft an diesem Eckpunkt weiter bewegen soll.
Random=Zufaellig
RandomAdvancementHelp=Waehlt eine zufaellige Richtung (ausser der Ankunftsrichtung).
Clockwise=Im Uhrzeigersinn
CWAdvancementHelp=Der Stein bewegt sich im Uhrzeigersinn von der Ankunftsrichtung weiter.
Counterclockwise=Gegen den Uhrzeigersinn
CCWAdvancementHelp=Der Stein bewegt sich gegen den Uhrzeigersinn von der Ankunftsrichtung weiter.
Instant=Instantan
InstantSpeedHelp=Der Stein wird sofort zur naechsten Ecke bewegt.
