Speed=Vitesse
SpeedHelp=Vitesse de déplacement en 1/100px par image.
Movement=Mouvement
MovementHelp=Dans quel motif cette brique doit être déplacée.
NoMovement=Aucun
NoMovementHelp=La brique ne bouge pas.
Horizontal=Horizontal
HorizontalHelp=Horizontalement de gauche à droite entre deux points.
Vertical=Vertical
VerticalHelp=Verticalement de haut en bas entre deux points.
Graph=Graphique
GraphHelp=Mouvement sur un graphique librement définissable. Ajouter/supprimer des points avec ctrl/shift.
Edge=Bord
EdgeHelp=Propriétés des bords
EdgeSpeedHelp=Vitesse de déplacement en 1/100px par image uniquement sur ce bord.
Default=Par défaut
DefaultHelp=Vitesse comme spécifié dans l'objet.
CustomSpeed=Personnalisé
CustomSpeedHelp=Ce bord a une vitesse personnalisée.
Vertex=Vertex
VertexHelp=Propriétés de ce sommet.
ArrivalAction=Action
ArrivalActionHelp=Action lorsque la brique atteint ce sommet.
VertexWaitTime=Temps d'attente
VertexWaitTimeHelp=Combien de temps attendre à cet endroit avant de poursuivre le mouvement.
Advancement=Direction du mouvement
AdvancementHelp=Dans quelle direction continuer le mouvement après l'arrivée à ce point de bord.
Random=Aléatoire
RandomAdvancementHelp=Choisit une direction aléatoire (excluant d'où elle vient).
Clockwise=Sens horaire
CWAdvancementHelp=La brique se déplace dans le sens horaire par rapport à son origine.
Counterclockwise=Sens anti-horaire
CCWAdvancementHelp=La brique se déplace dans le sens antihoraire par rapport à son origine.
Instant=Instantané
InstantSpeedHelp=La brique est acheminée directement au sommet suivant.

