Name=Apparition d'ennemis
Description=Lorsqu'il est activé, fait apparaître un ou plusieurs ennemis contrôlés par l'IA qui attaquent les joueurs.
Activate=Activer
ActivateHelp=Démarre l'apparition d'ennemis
Stop=Désactiver
StopHelp=Arrête l'apparition d'ennemis. 
RemoveSpawnedEnemies=Enlève les ennemis
RemoveSpawnedEnemiesHelp=Supprime tous les ennemis créés par ce générateur.
ActActivate=Activer l'apparition d'ennemis
ActStop=Arrêter l'apparition d'ennemis
SpawnPosition=Position
Here=Ici
InRange=Dans le rayon
SpawnInRangeHelp=Position aléatoire dans un rayon.
InRect=Dans le rectangle
SpawnInRectHelp=Position aléatoire dans un rectangle.
SpawnCount=Nombre d'ennemis
SpawnCountHelp=Nombre d'ennemis générés.
Infinite=Infini
FixedNumber=Nombre fixe
SpawnDelay=Retard
SpawnDelayHelp=Temps en frames entre l'activation de l'apparition et la création du premier ennemi.
SpawnInterval=Intervalle
SpawnIntervalHelp=Temps en frames entre chaque création ennemie. 0 pour la création immédiate de tous les ennemis.
AutoActivate=Auto-activé
AutoActivateHelp=Si vrai, le générateur s'active automatiquement lors de la première inscription du joueur.
AttackRange=Portée de l'attaque
AttackRangeHelp=Dans quelle plage les clonks créés doivent rechercher des ennemis.
Automatic=Automatique
AutomaticGuardRangeHelp=Les ennemis recherchent automatiquement à vue de leur emplacement cible.
Custom=Personnalisé
Color=Couleur
Bounty=Prime
BountyHelp=Tacot attribué au joueur pour avoir tué un ennemi engendré par ce générateur.
Enemy=Type d'ennemi
EnemyHelp=Type d'objet de l'attaquant.
None=Aucun
PlayerAttackers=Attaquant
ScaleX=Échelle X
ScaleXHelp=Mise à l'échelle horizontale du clonk généré en pourcentage de la taille par défaut.
ScaleY=Échelle Y
ScaleYHelp=Mise à l'échelle verticale du clonk généré en pourcentage de la taille par défaut.
Backpack=Sac-à-dos
BackpackHelp=Si le clonk porte un sac à dos.
Speed=Vitesse
SpeedHelp=Vitesse de déplacement du clonk en pourcentage de la valeur par défaut.
Energy=Energie
EnergyHelp=Points de vie du clonk engendré.
AttackPath=Chemin d'attaque
AttackPathHelp=Chemin le long duquel se déplacent les IA clonks. Trajectoire de vol pour les roquettes et sentier pour les clonks. Le vol complet est compensé par la position d'apparition si une plage d'apparition est donnée. Si un sommet du chemin d'attaque est placé sur une structure (par exemple une porte), les clonks attaqueront la structure.
MaxConcurrent=Ennemis simultanés maximum
MaxConcurrentHelp=Combien d'ennemis peuvent apparaître et être vivants en parallèle. Une fois ce nombre atteint, les réapparitions sont suspendues jusqu'à ce que certains ennemis soient tués.
Unlimited=Illimité
KillCheckTarget=Objet généré
AllSpawners=Tous les ennemis sont générés
KillCheckAllSpawnersHelp=Tous les ennemis précédemment activés apparaissent sur toute la carte.
ThisSeqeunceSpawners=Les apparitions lancées dans cette séquence
ThisSequenceSpawnersHelp=Tous les ennemis précédemment activés apparaissent à partir de cette action ou séquence.
SpecificSpawner=Apparition spécifique
SpecificSpawnerHelp=Sélection d'objets pour un générateur ennemi spécifique.
AllEnemiesKilled=Ennemi tué à l'apparition
AllEnemiesKilledHelp=Vrai si tous les ennemis d'un ou plusieurs objets d'apparition ennemis précédemment activés ont été tués ou supprimés.
AttackSpeed=Vitesse d'attaque
AttackSpeedHelp=Armes à distance uniquement: réglage de la vitesse de tir et de rechargement en pourcentage de la valeur par défaut. Des valeurs élevées signifient une prise de vue et un rechargement plus rapides.
Shield=Bouclier
ShieldHelp=Si le clonk ennemi porte un bouclier pour dévier les attaques.
SpawnAction=Action sur l'apparition
SpawnActionHelp=Action à exécuter pour chaque ennemi engendré. Peut être utilisé par exemple pour les effets graphiques.

